01 01 01 01 01 01 01 01 01 01 01 01 01 01 01 01 01 01 01 01
01 00 00 00 00 00 00 00 00 00 00 00 00 00 00 01 00 00 00 00
01 00 00 00 00 00 00 00 00 00 00 00 00 00 00 01 00 00 00 01
01 00 00 00 00 00 07 00 00 00 03 03 00 00 00 01 00 00 01 01
01 00 00 00 01 04 01 00 00 00 00 00 01 00 00 01 00 01 00 01
01 04 07 00 00 00 00 00 01 00 00 00 01 01 00 01 00 00 00 01
01 01 01 00 00 00 00 00 01 00 00 03 00 00 00 01 01 00 00 01
01 00 00 00 00 07 03 00 01 00 00 00 00 00 01 01 00 01 00 01
01 00 00 01 01 01 01 00 01 00 00 01 01 00 00 01 00 00 00 01
01 00 00 00 00 00 00 00 01 01 00 00 00 00 00 00 00 00 01 01
01 00 01 00 00 00 01 01 01 00 01 00 00 00 00 00 00 00 00 01
01 00 00 00 00 01 00 00 01 00 00 01 01 00 00 00 01 01 02 01
01 00 00 00 01 00 05 05 05 05 05 00 00 02 01 00 00 00 00 01
00 00 00 01 01 00 00 00 00 00 00 00 00 00 00 01 00 00 07 01
01 01 01 01 01 01 01 01 01 01 01 01 01 01 01 01 01 01 01 01