01 01 01 01 01 01 01 01 01 01 01 01 01 01 01 01 01 01 01 01
01 00 00 00 00 00 00 00 00 00 00 00 00 00 00 01 00 00 00 00
01 00 00 00 00 00 00 00 00 00 00 00 00 00 00 01 00 00 00 01
01 00 00 00 01 04 01 00 00 00 03 03 00 00 00 01 00 00 01 01
01 00 00 00 00 00 00 00 00 00 00 00 01 00 00 01 00 01 00 01
01 04 01 00 00 00 00 01 04 01 00 00 01 01 00 01 00 00 00 01
01 00 00 00 00 00 00 00 01 00 00 03 00 00 00 01 01 00 00 01
01 00 00 01 03 00 00 00 01 00 00 00 00 00 01 01 00 01 00 01
01 00 00 00 00 01 01 00 01 00 00 01 01 00 00 01 00 00 00 01
01 00 00 00 00 00 00 01 01 01 00 00 00 00 00 00 00 00 00 01
01 00 00 00 00 00 00 00 00 00 00 00 00 00 00 00 00 00 00 01
01 00 00 00 00 00 06 00 06 00 06 00 06 00 06 00 01 01 02 01
01 00 00 00 01 00 00 00 00 00 00 00 00 00 00 00 00 00 00 01
00 00 00 01 01 00 00 00 00 00 00 00 00 00 00 01 00 00 00 01
01 01 01 01 01 01 01 01 01 01 01 01 01 01 01 01 01 01 01 01